==================================
CLASS
==================================
LeptonFLiR	KEYWORD1

==================================
FUNCTIONS
==================================
init	KEYWORD2
getChipSelectPin	KEYWORD2
getISRVSyncPin	KEYWORD2
getI2CSpeed	KEYWORD2
getCameraType	KEYWORD2
getTemperatureMode	KEYWORD2
setUserDelayFuncs	KEYWORD2
setUserDigitalWriteFuncs	KEYWORD2
getImageWidth	KEYWORD2
getImageHeight	KEYWORD2
tryReadNextFrame	KEYWORD2
getFrameNumber	KEYWORD2
getTelemetryMode	KEYWORD2
getAGCEnabled	KEYWORD2
getTLinearEnabled	KEYWORD2
getPseudoColorLUTEnabled	KEYWORD2
isImageDataAvailable	KEYWORD2
getImageMode	KEYWORD2
getImageBpp	KEYWORD2
getImagePixelData	KEYWORD2
getImageOutputMode	KEYWORD2
getImageOutputBpp	KEYWORD2
getImageOutputPitch	KEYWORD2
getImageOutputTotalSize	KEYWORD2
getImageOutputData	KEYWORD2
isTelemetryDataAvailable	KEYWORD2
getTelemetryFrameCounter	KEYWORD2
getTelemetryShouldRunFFCNormalization	KEYWORD2
getTelemetryAGCEnabled	KEYWORD2
getTelemetryOutputData	KEYWORD2
agc_setAGCEnabled	KEYWORD2
agc_getAGCEnabled	KEYWORD2
agc_setAGCPolicy	KEYWORD2
agc_getAGCPolicy	KEYWORD2
agc_setHEQScaleFactor	KEYWORD2
agc_getHEQScaleFactor	KEYWORD2
agc_setAGCCalcEnabled	KEYWORD2
agc_getAGCCalcEnabled	KEYWORD2
agc_setHistogramRegion	KEYWORD2
agc_getHistogramRegion	KEYWORD2
agc_getHistogramStatistics	KEYWORD2
agc_setHistogramClipPercent	KEYWORD2
agc_getHistogramClipPercent	KEYWORD2
agc_setHistogramTailSize	KEYWORD2
agc_getHistogramTailSize	KEYWORD2
agc_setLinearMaxGain	KEYWORD2
agc_getLinearMaxGain	KEYWORD2
agc_setLinearMidpoint	KEYWORD2
agc_getLinearMidpoint	KEYWORD2
agc_setLinearDampeningFactor	KEYWORD2
agc_getLinearDampeningFactor	KEYWORD2
agc_setHEQDampeningFactor	KEYWORD2
agc_getHEQDampeningFactor	KEYWORD2
agc_setHEQMaxGain	KEYWORD2
agc_getHEQMaxGain	KEYWORD2
agc_setHEQClipLimitHigh	KEYWORD2
agc_getHEQClipLimitHigh	KEYWORD2
agc_setHEQClipLimitLow	KEYWORD2
agc_getHEQClipLimitLow	KEYWORD2
agc_setHEQBinExtension	KEYWORD2
agc_getHEQBinExtension	KEYWORD2
agc_setHEQMidpoint	KEYWORD2
agc_getHEQMidpoint	KEYWORD2
agc_setHEQEmptyCounts	KEYWORD2
agc_getHEQEmptyCounts	KEYWORD2
agc_setHEQNormalizationFactor	KEYWORD2
agc_getHEQNormalizationFactor	KEYWORD2
sys_getCameraStatus	KEYWORD2
sys_getFlirSerialNumber	KEYWORD2
sys_getCustomerSerialNumber	KEYWORD2
sys_getCameraUptime	KEYWORD2
sys_getAuxTemperature	KEYWORD2
sys_getFPATemperature	KEYWORD2
sys_setTelemetryEnabled	KEYWORD2
sys_getTelemetryEnabled	KEYWORD2
sys_setTelemetryLocation	KEYWORD2
sys_getTelemetryLocation	KEYWORD2
sys_runFFCNormalization	KEYWORD2
sys_runPingCamera	KEYWORD2
sys_runFrameAveraging	KEYWORD2
sys_setNumFramesToAverage	KEYWORD2
sys_getNumFramesToAverage	KEYWORD2
sys_getSceneStatistics	KEYWORD2
sys_setSceneRegion	KEYWORD2
sys_getSceneRegion	KEYWORD2
sys_getThermalShutdownCount	KEYWORD2
sys_setShutterPosition	KEYWORD2
sys_getShutterPosition	KEYWORD2
sys_setFFCShutterMode	KEYWORD2
sys_getFFCShutterMode	KEYWORD2
sys_getFFCNormalizationStatus	KEYWORD2
vid_setPolarity	KEYWORD2
vid_getPolarity	KEYWORD2
vid_setPseudoColorLUT	KEYWORD2
vid_getPseudoColorLUT	KEYWORD2
vid_setFocusCalcEnabled	KEYWORD2
vid_getFocusCalcEnabled	KEYWORD2
vid_setFreezeEnabled	KEYWORD2
vid_getFreezeEnabled	KEYWORD2
vid_setOutputFormat	KEYWORD2
vid_getOutputFormat	KEYWORD2
vid_setUserColorLUT	KEYWORD2
vid_getUserColorLUT	KEYWORD2
vid_setFocusRegion	KEYWORD2
vid_getFocusRegion	KEYWORD2
vid_setFocusThreshold	KEYWORD2
vid_getFocusThreshold	KEYWORD2
vid_getFocusMetric	KEYWORD2
vid_setSceneBasedNUCEnabled	KEYWORD2
vid_getSceneBasedNUCEnabled	KEYWORD2
vid_setGamma	KEYWORD2
vid_getGamma	KEYWORD2
kelvin100ToTemperature	KEYWORD2
temperatureToKelvin100	KEYWORD2
getTemperatureSymbol	KEYWORD2
getLastI2CError	KEYWORD2
getLastLepResult	KEYWORD2
getCameraVersion	KEYWORD2
getWireInterfaceNumber	KEYWORD2
printModuleInfo	KEYWORD2
checkForErrors	KEYWORD2
wordsToHexString	KEYWORD2

==================================
CONSTANTS
==================================
FLT_EPSILON	LITERAL1
ENABLED	LITERAL1
DISABLED	LITERAL1
LEPFLIR_GEN_CMD_TIMEOUT	LITERAL1
LEPFLIR_SPI_MAX_SPEED	LITERAL1
LEPFLIR_SPI_OPTIMAL_MIN_SPEED	LITERAL1
LEPFLIR_SPI_MIN_SPEED	LITERAL1
LeptonFLiR_CameraType_Lepton1	LITERAL1
LeptonFLiR_CameraType_Lepton1_5	LITERAL1
LeptonFLiR_CameraType_Lepton1_6	LITERAL1
LeptonFLiR_CameraType_Lepton2	LITERAL1
LeptonFLiR_CameraType_Lepton2_5	LITERAL1
LeptonFLiR_CameraType_Lepton3	LITERAL1
LeptonFLiR_CameraType_Lepton3_5	LITERAL1
LeptonFLiR_CameraType_Count	LITERAL1
LeptonFLiR_CameraType_Undefined	LITERAL1
LeptonFLiR_TemperatureMode_Celsius	LITERAL1
LeptonFLiR_TemperatureMode_Fahrenheit	LITERAL1
LeptonFLiR_TemperatureMode_Kelvin	LITERAL1
LeptonFLiR_TemperatureMode_Count	LITERAL1
LeptonFLiR_TemperatureMode_Undefined	LITERAL1
LeptonFLiR_ImageMode_80x60_24bpp_244Brf	LITERAL1
LeptonFLiR_ImageMode_80x60_16bpp_164Brf	LITERAL1
LeptonFLiR_ImageMode_160x120_24bpp_244Brf	LITERAL1
LeptonFLiR_ImageMode_160x120_16bpp_164Brf	LITERAL1
LeptonFLiR_ImageMode_Count	LITERAL1
LeptonFLiR_ImageMode_Undefined	LITERAL1
LeptonFLiR_ImageOutputMode_GS8	LITERAL1
LeptonFLiR_ImageOutputMode_GS16	LITERAL1
LeptonFLiR_ImageOutputMode_RGB565	LITERAL1
LeptonFLiR_ImageOutputMode_RGB888	LITERAL1
LeptonFLiR_ImageOutputMode_Count	LITERAL1
LeptonFLiR_ImageOutputMode_Undefined	LITERAL1
LeptonFLiR_TelemetryMode_Disabled	LITERAL1
LeptonFLiR_TelemetryMode_Header	LITERAL1
LeptonFLiR_TelemetryMode_Footer	LITERAL1
LeptonFLiR_TelemetryFFCState_NeverCommanded	LITERAL1
LeptonFLiR_TelemetryFFCState_InProgress	LITERAL1
LeptonFLiR_TelemetryFFCState_Complete	LITERAL1
LeptonFLiR_TelemetryGainMode_High	LITERAL1
LeptonFLiR_TelemetryGainMode_Low	LITERAL1
LeptonFLiR_TelemetryGainMode_Auto	LITERAL1
LEP_AGC_LINEAR	LITERAL1
LEP_AGC_HEQ	LITERAL1
LEP_AGC_SCALE_TO_8_BITS	LITERAL1
LEP_AGC_SCALE_TO_14_BITS	LITERAL1
LEP_SYSTEM_READY	LITERAL1
LEP_SYSTEM_INITIALIZING	LITERAL1
LEP_SYSTEM_IN_LOW_POWER_MODE	LITERAL1
LEP_SYSTEM_GOING_INTO_STANDBY	LITERAL1
LEP_SYSTEM_FLAT_FIELD_IN_PROCESS	LITERAL1
LEP_TELEMETRY_LOCATION_HEADER	LITERAL1
LEP_TELEMETRY_LOCATION_FOOTER	LITERAL1
LEP_SYS_FA_DIV_1	LITERAL1
LEP_SYS_FA_DIV_2	LITERAL1
LEP_SYS_FA_DIV_4	LITERAL1
LEP_SYS_FA_DIV_8	LITERAL1
LEP_SYS_FA_DIV_16	LITERAL1
LEP_SYS_FA_DIV_32	LITERAL1
LEP_SYS_FA_DIV_64	LITERAL1
LEP_SYS_FA_DIV_128	LITERAL1
LEP_SYS_SHUTTER_POSITION_UNKNOWN	LITERAL1
LEP_SYS_SHUTTER_POSITION_IDLE	LITERAL1
LEP_SYS_SHUTTER_POSITION_OPEN	LITERAL1
LEP_SYS_SHUTTER_POSITION_CLOSED	LITERAL1
LEP_SYS_SHUTTER_POSITION_BRAKE_ON	LITERAL1
LEP_SYS_FFC_SHUTTER_MODE_MANUAL	LITERAL1
LEP_SYS_FFC_SHUTTER_MODE_AUTO	LITERAL1
LEP_SYS_FFC_SHUTTER_MODE_EXTERNAL	LITERAL1
LEP_SYS_SHUTTER_LOCKOUT_INACTIVE	LITERAL1
LEP_SYS_SHUTTER_LOCKOUT_HIGH	LITERAL1
LEP_SYS_SHUTTER_LOCKOUT_LOW	LITERAL1
LEP_SYS_FFC_STATUS_WRITE_ERROR	LITERAL1
LEP_SYS_FFC_STATUS_ERROR	LITERAL1
LEP_SYS_FFC_STATUS_READY	LITERAL1
LEP_SYS_FFC_STATUS_BUSY	LITERAL1
LEP_SYS_FRAME_AVERAGE_COLLECTING_FRAMES	LITERAL1
LEP_VID_WHITE_HOT	LITERAL1
LEP_VID_BLACK_HOT	LITERAL1
LEP_VID_WHEEL6_LUT	LITERAL1
LEP_VID_FUSION_LUT	LITERAL1
LEP_VID_RAINBOW_LUT	LITERAL1
LEP_VID_GLOBOW_LUT	LITERAL1
LEP_VID_SEPIA_LUT	LITERAL1
LEP_VID_COLOR_LUT	LITERAL1
LEP_VID_ICE_FIRE_LUT	LITERAL1
LEP_VID_RAIN_LUT	LITERAL1
LEP_VID_USER_LUT	LITERAL1
LEP_VID_VIDEO_OUTPUT_FORMAT_RAW8	LITERAL1
LEP_VID_VIDEO_OUTPUT_FORMAT_RAW10	LITERAL1
LEP_VID_VIDEO_OUTPUT_FORMAT_RAW12	LITERAL1
LEP_VID_VIDEO_OUTPUT_FORMAT_RGB888	LITERAL1
LEP_VID_VIDEO_OUTPUT_FORMAT_RGB666	LITERAL1
LEP_VID_VIDEO_OUTPUT_FORMAT_RGB565	LITERAL1
LEP_VID_VIDEO_OUTPUT_FORMAT_YUV422_8BIT	LITERAL1
LEP_VID_VIDEO_OUTPUT_FORMAT_RAW14	LITERAL1
LEP_VID_VIDEO_OUTPUT_FORMAT_YUV422_10BIT	LITERAL1
LEP_VID_VIDEO_OUTPUT_FORMAT_USER_DEFINED	LITERAL1
LEP_VID_VIDEO_OUTPUT_FORMAT_RAW8_2	LITERAL1
LEP_VID_VIDEO_OUTPUT_FORMAT_RAW8_3	LITERAL1
LEP_VID_VIDEO_OUTPUT_FORMAT_RAW8_4	LITERAL1
LEP_VID_VIDEO_OUTPUT_FORMAT_RAW8_5	LITERAL1
LEP_VID_VIDEO_OUTPUT_FORMAT_RAW8_6	LITERAL1
LEP_VIDEO_OUTPUT_SOURCE_RAW	LITERAL1
LEP_VIDEO_OUTPUT_SOURCE_COOKED	LITERAL1
LEP_VIDEO_OUTPUT_SOURCE_RAMP	LITERAL1
LEP_VIDEO_OUTPUT_SOURCE_CONSTANT	LITERAL1
LEP_VIDEO_OUTPUT_SOURCE_RAMP_H	LITERAL1
LEP_VIDEO_OUTPUT_SOURCE_RAMP_V	LITERAL1
LEP_VIDEO_OUTPUT_SOURCE_RAMP_CUSTOM	LITERAL1
LEP_VIDEO_OUTPUT_SOURCE_FRAME_CAPTURE	LITERAL1
LEP_VIDEO_OUTPUT_SOURCE_FRAME_FREEZE	LITERAL1
LEP_VIDEO_OUTPUT_SOURCE_FRAME_0	LITERAL1
LEP_VIDEO_OUTPUT_SOURCE_FRAME_1	LITERAL1
LEP_VIDEO_OUTPUT_SOURCE_FRAME_2	LITERAL1
LEP_VIDEO_OUTPUT_SOURCE_FRAME_3	LITERAL1
LEP_VIDEO_OUTPUT_SOURCE_FRAME_4	LITERAL1
LEP_OEM_STATUS_OTP_WRITE_ERROR	LITERAL1
LEP_OEM_STATUS_ERROR	LITERAL1
LEP_OEM_STATUS_READY	LITERAL1
LEP_OEM_STATUS_BUSY	LITERAL1
LEP_OEM_FRAME_AVERAGE_COLLECTING_FRAMES	LITERAL1
LEP_OEM_GPIO_MODE_GPIO	LITERAL1
LEP_OEM_GPIO_MODE_I2C_MASTER	LITERAL1
LEP_OEM_GPIO_MODE_SPI_MASTER_VLB_DATA	LITERAL1
LEP_OEM_GPIO_MODE_SPIO_MASTER_REG_DATA	LITERAL1
LEP_OEM_GPIO_MODE_SPI_SLAVE_VLB_DATA	LITERAL1
LEP_OEM_GPIO_MODE_VSYNC	LITERAL1
LEP_OEM_VSYNC_DELAY_MINUS_3	LITERAL1
LEP_OEM_VSYNC_DELAY_MINUS_2	LITERAL1
LEP_OEM_VSYNC_DELAY_MINUS_1	LITERAL1
LEP_OEM_VSYNC_DELAY_NONE	LITERAL1
LEP_OEM_VSYNC_DELAY_PLUS_1	LITERAL1
LEP_OEM_VSYNC_DELAY_PLUS_2	LITERAL1
LEP_OEM_VSYNC_DELAY_PLUS_3	LITERAL1
LEP_OEM_USER_PARAMS_STATE_NOT_WRITTEN	LITERAL1
LEP_OEM_USER_PARAMS_STATE_WRITTEN	LITERAL1
LEP_RAD_TS_USER_MODE	LITERAL1
LEP_RAD_TS_CAL_MODE	LITERAL1
LEP_RAD_TS_FIXED_MODE	LITERAL1
LEP_RAD_STATUS_ERROR	LITERAL1
LEP_RAD_STATUS_READY	LITERAL1
LEP_RAD_STATUS_BUSY	LITERAL1
LEP_RAD_FRAME_AVERAGE_COLLECTING_FRAMES	LITERAL1
LEP_RAD_RESOLUTION_0_1	LITERAL1
LEP_RAD_RESOLUTION_0_01	LITERAL1
LEP_OK	LITERAL1
LEP_COMM_OK	LITERAL1
LEP_ERROR	LITERAL1
LEP_NOT_READY	LITERAL1
LEP_RANGE_ERROR	LITERAL1
LEP_CHECKSUM_ERROR	LITERAL1
LEP_BAD_ARG_POINTER_ERROR	LITERAL1
LEP_DATA_SIZE_ERROR	LITERAL1
LEP_UNDEFINED_FUNCTION_ERROR	LITERAL1
LEP_FUNCTION_NOT_SUPPORTED	LITERAL1
LEP_OTP_WRITE_ERROR	LITERAL1
LEP_OTP_READ_ERROR	LITERAL1
LEP_OTP_NOT_PROGRAMMED_ERROR	LITERAL1
LEP_ERROR_I2C_BUS_NOT_READY	LITERAL1
LEP_ERROR_I2C_BUFFER_OVERFLOW	LITERAL1
LEP_ERROR_I2C_ARBITRATION_LOST	LITERAL1
LEP_ERROR_I2C_BUS_ERROR	LITERAL1
LEP_ERROR_I2C_NACK_RECEIVED	LITERAL1
LEP_ERROR_I2C_FAIL	LITERAL1
LEP_DIV_ZERO_ERROR	LITERAL1
LEP_COMM_PORT_NOT_OPEN	LITERAL1
LEP_COMM_INVALID_PORT_ERROR	LITERAL1
LEP_COMM_RANGE_ERROR	LITERAL1
LEP_ERROR_CREATING_COMM	LITERAL1
LEP_ERROR_STARTING_COMM	LITERAL1
LEP_ERROR_CLOSING_COMM	LITERAL1
LEP_COMM_CHECKSUM_ERROR	LITERAL1
LEP_COMM_NO_DEV	LITERAL1
LEP_TIMEOUT_ERROR	LITERAL1
LEP_COMM_ERROR_WRITING_COMM	LITERAL1
LEP_COMM_ERROR_READING_COMM	LITERAL1
LEP_COMM_COUNT_ERROR	LITERAL1
LEP_OPERATION_CANCELED	LITERAL1
LEP_UNDEFINED_ERROR_CODE	LITERAL1

==================================
DATA TYPES
==================================
LeptonFLiR_CameraType	KEYWORD1
LeptonFLiR_TemperatureMode	KEYWORD1
LeptonFLiR_ImageMode	KEYWORD1
LeptonFLiR_ImageOutputMode	KEYWORD1
LeptonFLiR_TelemetryMode	KEYWORD1
LeptonFLiR_TelemetryFFCState	KEYWORD1
LeptonFLiR_TelemetryGainMode	KEYWORD1
LeptonFLiR_TelemetryData	KEYWORD1
LeptonFLiR_PixelData	KEYWORD1
LEP_AGC_POLICY	KEYWORD1
LEP_AGC_HISTOGRAM_ROI	KEYWORD1
LEP_AGC_HISTOGRAM_STATISTICS	KEYWORD1
LEP_AGC_HEQ_SCALE_FACTOR	KEYWORD1
LEP_SYS_CAM_STATUS_STATES	KEYWORD1
LEP_SYS_CAM_STATUS	KEYWORD1
LEP_SYS_TELEMETRY_LOCATION	KEYWORD1
LEP_SYS_FRAME_AVERAGE	KEYWORD1
LEP_SYS_SCENE_STATISTICS	KEYWORD1
LEP_SYS_SCENE_ROI	KEYWORD1
LEP_SYS_SHUTTER_POSITION	KEYWORD1
LEP_SYS_FFC_SHUTTER_MODE_STATE	KEYWORD1
LEP_SYS_SHUTTER_TEMP_LOCKOUT_STATE	KEYWORD1
LEP_SYS_FFC_SHUTTER_MODE	KEYWORD1
LEP_SYS_FFC_STATUS	KEYWORD1
LEP_VID_POLARITY	KEYWORD1
LEP_VID_PCOLOR_LUT	KEYWORD1
LEP_VID_LUT_PIXEL	KEYWORD1
LEP_VID_LUT_BUFFER	KEYWORD1
LEP_VID_FOCUS_ROI	KEYWORD1
LEP_VID_VIDEO_OUTPUT_FORMAT	KEYWORD1
LEP_OEM_VIDEO_OUTPUT_SOURCE	KEYWORD1
LEP_OEM_STATUS	KEYWORD1
LEP_OEM_GPIO_MODE	KEYWORD1
LEP_OEM_VSYNC_DELAY	KEYWORD1
LEP_OEM_USER_PARAMS_STATE	KEYWORD1
LEP_OEM_SHUTTER_PROFILE	KEYWORD1
LEP_RBFO	KEYWORD1
LEP_RAD_TS_MODE	KEYWORD1
LEP_RAD_STATUS	KEYWORD1
LEP_RAD_FLUX_LINEAR_PARAMS	KEYWORD1
LEP_RAD_TLINEAR_RESOLUTION	KEYWORD1
LEP_RAD_ROI	KEYWORD1
LEP_RAD_SPOTMETER_VALUES	KEYWORD1
LEP_RESULT	KEYWORD1
